┌─────────────────────┐                            
│·····················│                            
│·····················│                            
│·····················│                            
│·····················│               ┌───────────┐
│·····················│               │···········│
│·····················│               │···········│
│·····················│               │···········│
│·····················│               │···········│
│·····················│               │···········│
│·····················│               │···········│
│·····················│               │···········│
│·····················│               └───────────┘
│·····················│                            
│·····················│                            
└─────────────────────┘                            